M.1 S.7
1111191
11110011
1110111
11111111
1110111
11111111
1110111
11111111
1110111
11100111
1100011
11000111
1011111
11111111
1711111

M.2 S.7
1111911
11101111
1100011
11111111
1100011
11111111
1100011
11111111
1100011
11111111
1100011
11111111
1100011
11110111
1171111

M.3 S.7
1119111
11111111
1110111
11111111
1110111
11110001
1111110
10000001
0111111
10001111
1110111
11111111
1110111
11111111
1117111

M.4 S.7
1191111
11100001
1111110
11110001
1110111
11111111
1110111
11100111
1101011
10011111
0111111
11111111
0111111
11111111
7111111

M.5 S.7
1111111
10000001
1011110
91000011
0101110
10110001
0100111
11011001
0010010
11011101
0100001
10111117
0100000
10010101
1111111

M.6 S.7
1911111
11001111
1110111
11111111
1110111
11111117
1110110
11001111
1011110
11111111
1011110
11000001
1111111
11111111
1111111

M.7 S.7
1111111
11011011
1001001
11111111
1001001
11100111
1011101
11111111
1011101
11111111
1011101
11111111
1011101
11111111
1711191

M.8 S.7
1111111
11111111
1111111
11111111
1111111
11111109
1111101
11111111
1111101
10011111
0101101
11111011
0101011
10100111
1711111

M.9 S.7
1111111
11000001
1011110
10111111
0111110
71111111
0111110
10011111
1101110
11011111
1011110
11011119
1101110
11100001
1111111

M.10 S.7
1111119
11111111
1111110
11111101
1111101
11111011
1111011
11100111
1101111
11011111
1011111
10111111
0111111
11111111
7111111