M.1 S.8
11111111
111111111
11111111
111111111
11111111
111011009
11000011
111110111
11000111
111101111
11011111
111111111
11011111
111111111
11011111
111111111
11711111

M.2 S.8
19111111
110000001
11111110
110011111
10101110
110101111
11010110
110110111
10111010
110111011
11011100
110111101
10111111
110111111
11011111
110111111
17111111

M.3 S.8
11111111
101010101
00000000
101010101
00000000
101010101
00000000
101010101
00000000
101010101
00000000
101010101
00000000
101010101
00000000
110101011
71111119

M.4 S.8
11119111
111000001
11011110
111111101
11011101
111111101
11011110
111011111
11001110
100011101
01111101
100111111
11011101
111111111
11011101
111000011
11171111

M.5 S.8
11111111
111111111
11111111
111111111
11111111
911101111
01100111
100010001
11100110
111101111
11111110
111111111
11111110
111111111
11111110
111111111
11111117

M.6 S.8
11111111
100000001
01111110
111111111
01111110
111111001
01111001
111111019
01111010
711111111
11111010
111111111
11111010
111111111
11111010
111111001
11111111

M.7 S.8
11111111
110000001
00111110
111000001
00011111
111100001
00001110
111110001
00000111
111111001
00000010
111111101
00000001
111111117
00000000
101010101
11111111

M.8 S.8
11111111
111111109
11111101
111111011
11111011
111110111
11110111
111101111
11101111
111011111
11011111
110111111
10111111
111111111
10111111
111111111
17111111

M.9 S.8
11111111
900111111
11011111
111011111
11101111
111101111
11110111
111110011
11111101
111110011
11110111
111101111
11101111
111011111
11011111
700111111
11111111

M.10 S.8
17111191
110010011
11100111
100010001
01111110
100010001
11100111
100010001
01111110
101111101
10111101
110000011
11111111
111111111
11111111
111111111
11111111